30 15
==============================
=     |       |+             =
=     |	      |              =
=     |       |              =
=----------------------------=
=                   |        =
=                   |        =
=                   |        =
=----------------------------=
=      |                     =
=      |                     =
=      |---------------------=
=      |     |    |    |     =
=      |     |    |    |     =
==============================
